2 2 2 2 2 2 1 0 0 1 2 2 2 2 2 2
2 2 2 2 6 6 1 0 0 1 2 6 2 2 2 2
2 2 2 2 6 1 1 0 0 1 1 6 6 2 2 2
2 10 9 6 1 1 0 0 0 0 1 1 10 9 6 2
1 1 1 1 1 0 0 0 0 0 0 1 1 1 1 1
0 0 0 0 0 0 0 0 0 0 0 0 0 0 0 0
0 0 0 0 0 0 0 0 0 0 0 0 0 0 0 0
1 1 1 1 1 0 0 0 0 0 0 1 1 1 1 1
10 9 6 6 1 1 0 0 0 0 1 1 6 2 10 9
2 2 2 6 6 1 1 0 0 1 1 6 6 2 2 2
2 2 2 2 6 6 1 0 0 1 2 2 2 2 2 2
2 2 2 2 2 2 1 0 0 1 2 2 2 2 2 2