10 9 10 9 10 9 1 0 0 1 10 9 10 9 10 9
8 6 6 2 1 1 1 0 0 1 2 2 2 1 1 7
8 2 0 0 0 0 0 0 0 0 0 0 0 0 1 7
8 1 0 3 3 3 3 3 3 3 3 3 3 0 0 7
8 1 0 3 3 3 3 3 3 3 3 3 3 0 1 7
8 1 0 3 3 3 3 3 3 3 3 3 3 0 2 7
8 2 0 3 3 3 3 3 3 3 3 3 3 0 2 7
8 1 0 3 3 3 3 3 3 3 3 3 3 0 2 7
8 0 0 0 0 0 0 0 0 0 0 0 0 0 6 7
8 2 6 1 1 1 0 6 2 0 1 1 1 6 6 7
8 2 2 2 2 2 0 2 2 2 0 1 2 2 2 7
10 9 10 9 10 9 10 9 10 9 10 9 10 9 10 9