10 9 10 9 10 9 10 9 10 9 10 9 10 9 10 9
8 2 2 6 6 70 71 72 73 74 75 1 1 6 6 7
8 2 2 6 77 78 79 80 81 82 83 84 1 6 2 7
8 2 0 1 85 86 87 88 89 90 91 92 0 0 2 7
1 0 0 0 93 94 95 96 97 98 99 100 0 0 2 7
0 1 1 0 101 102 103 104 105 106 107 108 0 0 2 7
0 0 0 0 109 110 111 112 113 114 115 116 1 0 2 7
1 0 1 0 117 118 119 120 121 122 123 124 1 0 2 7
8 2 0 0 125 126 127 128 129 130 131 132 1 0 2 7
8 6 2 2 0 0 0 0 0 0 0 0 0 6 2 7
8 6 6 2 2 2 0 1 0 0 0 2 2 2 2 7
10 9 10 9 10 9 10 9 10 9 10 9 10 9 10 9