10 9 10 9 10 9 10 9 10 9 10 9 10 9 10 9
8 2 2 2 2 1 1 1 6 2 2 2 145 146 2 7
8 2 149 6 33 34 35 36 37 38 1 2 147 148 6 7
8 2 1 0 39 40 41 42 43 44 0 6 2 2 6 7
8 6 0 0 45 46 47 48 49 50 0 0 1 2 1 1
8 6 0 1 51 52 53 54 55 56 0 0 1 0 0 0
8 6 0 1 57 58 59 60 61 62 0 0 0 2 0 0
8 2 0 0 63 64 65 66 67 68 0 0 2 2 2 1
8 2 1 0 0 0 0 1 1 0 0 2 2 2 2 7
8 6 1 1 0 0 0 0 0 0 2 2 6 2 2 7
8 6 2 2 2 2 2 2 2 2 2 6 6 6 2 7
10 9 10 9 10 9 10 9 10 9 10 9 10 9 10 9