2 2 27 27 2 28 28 2 2 29 29 2 30 30 2 2
6 6 27 27 6 28 28 6 6 29 29 6 30 30 6 6
6 2 2 2 2 2 2 2 2 2 2 2 2 2 2 6
26 26 2 2 2 2 2 2 2 2 2 2 2 2 31 31
26 26 2 2 2 2 2 2 2 2 2 2 2 2 31 31
6 2 2 2 2 2 2 2 0 2 2 2 2 2 2 6
25 25 2 2 2 2 2 1 2 1 2 2 2 2 32 32
25 25 2 2 2 2 1 2 0 1 2 2 2 2 32 32
6 2 2 2 2 2 0 0 1 2 2 2 2 2 2 6
6 6 2 2 2 2 2 1 2 1 2 2 2 2 6 6
0 0 6 2 2 2 1 0 0 1 2 2 2 6 0 0
10 9 6 2 2 2 1 0 0 1 2 2 2 6 10 9